3,3,3,3,3,3,3,3,3,3,3,3
3,1,1,1,1,1,1,1,1,1,1,3
3,1,2,2,1,1,1,1,2,2,1,3
3,1,1,1,1,1,1,1,1,1,1,3
3,3,3,1,1,1,1,3,3,3,3,3
4,4,4,4,7,7,4,4,4,4,4,4
1,1,1,1,1,1,1,1,1,1,1,1
1,1,1,1,1,1,1,1,1,1,1,1
1,1,1,1,1,8,8,1,1,1,1,1
1,1,1,1,1,1,1,1,1,1,1,1
