8,8,8,8,8,8,8,8,8,8,8,8,8,8,8
8,1,1,1,1,1,1,1,1,1,1,1,1,1,8
8,1,2,2,1,1,1,1,1,1,1,2,2,1,8
8,1,2,3,3,1,1,1,1,1,3,3,2,1,8
8,1,1,1,1,4,4,4,4,4,1,1,1,1,8
8,1,1,1,1,4,7,5,7,4,1,1,1,1,8
8,1,1,1,1,4,4,4,4,4,1,1,1,1,8
8,1,2,3,3,1,1,1,1,1,3,3,2,1,8
8,1,2,2,1,1,1,1,1,1,1,2,2,1,8
8,1,1,1,1,1,1,6,1,1,1,1,1,1,8
8,1,1,1,1,1,1,1,1,1,1,1,1,1,8
8,8,8,8,8,8,8,8,8,8,8,8,8,8,8
